22 14
BBBBBBBBBBBBBBBBBBBBBB
BSEEDWEEEEEEEEEBEEWWEB
BEEEDDDDEEEEEEEBEFFEEB
BEEEEEEEEEEEEEEEBBBBBB
BFFEEEEEEEEEEEEEEEFFFB
BDDEEEFFWWEEEEEEEEEEEB
BFDEEEEEWWEEEEEEEEEEEB
BEDEEEEEEEEEEEEEEEEEEB
BEDEEEEEEEEEEEEEEEEEEB
BEEEEEEEEEEEEEEEEEEEEB
BBBBDDBBBBBBBBBBEBBBBB
BEEEEEWWWWEEEEEEEEEEEB
BEEEFFFFEEFFFFEEEEEEEB
BBBBBBBBBBBBBBBBBBBBBB