10 12
300000000004
000200000020
022200000000
000110000000
000000020000
000100020003
003330000003
033330001000
000000000000
000001000003
001111000002