50 50
BBBBBBBBBBBBBBBBBBBBBBBBBBBBBBBBBBBBBBBBBBBBBBBBBB
BSEEEEEEEEEEEEEEEDWWEEEEEEEEDFFFFDEEEEBWWWWWEEEFFB
BEEEEEEDDDEEEEEEEDWWEEEEEEEEDFFFFDEEEEBWWWWWEEEFFB
BEEEEEEDDDEEEEEEEDDDDDEEEEEEDFFFFDEEEEBEEEEEEEEFFB
BEEEEEEEEEEEEEEEEEEEEEEEEEEEDDDEDDEEEEEEEEEEEEEEEB
BEEEEEEEEEEEEEEEEEEEEEEEEEEEEEEEEEEEEEBEEEEEEEEEEB
BEEEEEEEEEEEEEEEEEEEEEEEEEEEEEEEEEEEEEBBBBBBBBBDDB
BEEEEEEEEEEEEEEEEEEEEEEEEEEEEEEEEEEEEEEEEEEEEEEEEB
BDDDDDEEEEEEEEEEEEEEEEEEEEEEEEEEEEEEEEEEEEEEEEEEEB
BFFDEEEEEEEEEEEEEEEFFFFFFFFEEEEEEEEEEEEEEEEEEEEEEB
BFFDEEEEEEEEEEEEEEEEEEFFFFFEEEEEEEEEEEEEEEEEEEEEEB
BEEDEEEEEEEEEEEEEEEEEEEEEEEEEEEEEEEEEEEEEEEEEEEEEB
BEEEEEEEEEEEEEEEEEEEEEEEEEEEEEEEEEEEEEEEEEEEEEEEEB
BEEDDDEEEEEEEEEEEEEEEEEEEEEEEEEEEEEEEEEEEEDDEEEEEB
BWWDEEEEEEEEEEEEEEEEEEEEEEEEEWWWEEEEEEEEEEDDEEEEEB
BWWDEEEEEEEEEEEEEEEEEEEEEEEEEWWWWWWEEEEEEEDDEEEEEB
BDDDEEEEEEEEEEEDDDDDEEEEEEEEEWWWWWWEEEEEEEDDEEEEEB
BEEEEEEEEEEEEEEDWWWEEEEEEEEEEEEEEEEEEEEEEEDDEEEEEB
BEEEEEEEEEEEEEEDWWWEEEEEEEEEEEEEEEEEEEEEEEEEEEEEEB
BEEEEEEEEEEEEEEDWWWEEEEEEEEEEEEEEEEEEEEEEEEEEEEEEB
BEEEEEEEEEEEEEEDDDDDEEEEEEEEEEEEEEEEEEEEEEEEEBBBEB
BDDDEEEEEEEEEEEEEEEEEEEEEEEEEEEEEEEEEEEEEEEEEBWEEB
BWWWDEEEEEEEEEEEEEEEEEEEEEEEEEEEEEEEEEEEEEEEEBWEEB
BWWWDEEEEEEEEEEEEEEEEEEEEEEEEEEEEEEEEEEEEEEEEBWWWB
BBBBBBBBBBBBBBBBBBBBBBBBBBBBBBBBBBBBBBBBBDDEBBBBBB
BFFFDFEEEEEEEEEWDEEEEEEEWWDEEEEEEEEEEEEEEEEEEEEEEB
BFFFDFEEEEEEEEEWDEEEEEEEWWDEEEEEEEEEEEEEEEEEEEEEEB
BEEEDFEEEEEEEEEWDEEEEFFFWWDEEEEEEEEEEEEEEEEEEEEEEB
BEEEDDDDDDDDEEDDDEEEDDDDDDDEEEEEEEEEEEEEEEEEEEEEEB
BEEEDEEEEEEEEEEEEEEEEEEEEEEEEEEEEEEEEEEEEEEEEEEEEB
BEEEDEEEEEEEEEEEEEEEEEEEEEEEEEEEEEEEEEEEEEEEEEEEEB
BEEEDEEEEEEEEEEEEEEEEEEEEEEEEEEEEEDDDDDDEEEEEEEEEB
BEEEEEEEEEEEEEEEEEEEEEEEEEFFEEEEEEDWWEEDEEEEEEEEEB
BEEEEEEEEEEEEEEEEEEEEEEEEEFFEEEEEEDWWEEEEEEEEEEEEB
BEEEDEEEEEEEEEEEEEEEEEEEEEFFEEEEEEDDDDDDEEEEEEEEEB
BEEEDEEEEEEEEEEEEEEEEEEEEEEEEEEEEEEEEEEEEEEEEEEEEB
BEEEDEEEEEEEEEEDDDDDDEEEEEEEEEEEEEEEEEEEEEEEEEEEEB
BWWWDEEEEEEEEEEEEEWWDEEEEEEEEEEEEEEEEEEEEEEEEEEEEB
BWWWDEEEEEEEEEEEEEWWDEEEEEEEEEEEEEEEEEEEEEEEEEEEEB
BBBBBBBBBBBBBBBBBBBBBBBBBDDDBBBBBBBBBBBBBBBBEEEBBB
BFFFFDEEEEEEEEWWDEEEEEEEEEEEEEDWWEEEEEFFFDEEEEEEEB
BFFFFDEEEEEEEEWWDEEEEEEEEEEEEEDWWEEEEEFFFDEEEEEEEB
BEEEEDEEEDDDDDDDDEEEEEEEEEEEEEDDDDDDEDDDDDEEEEEEEB
BEEEEDEEEEEEEEEEEEEEEEEEEEEEEEEEEEEEEEEEEEEEEEEEEB
BEEEEDEEEEEEEEEEEEEEEEEEEEEEEEEEEEEEEEEEEEEEEEEEEB
BEEEDDEEEEEEEEEEEEEEEEEEEEEEEEEEEEEEEEEEEEEEEEEEEB
BEDDDEEEEEEEEEEEEEEEEEEEEEEEEEEEEEEEEEEEEEEEEEEEEB
BEEEEEEEEEEEEEEEEEEEEWWWWWWWEEEEEEEEEEEEEEEEEEEEEB
BEEEEEEEEEEEEEEEEEEEEWWWWWWWEEEEEEEEEEEEEEEEEEEEEB
BBBBBBBBBBBBBBBBBBBBBBBBBBBBBBBBBBBBBBBBBBBBBBBBBB