100 100
BBBBBBBBBBBBBBBBBBBBBBBBBBBBBBBBBBBBBBBBBBBBBBBBBBBBBBBBBBBBBBBBBBBBBBBBBBBBBBBBBBBBBBBBBBBBBBBBBBBB
BSEEEEEEEEEEEEEEEDWWEEEEEEEEDFFFFDEEEEBWWWWWEEEFFFFFFEEEEEEEEEEEEEEEEEBWWWWWWWWEEEEEEEEEFFFFFDDWWWWB
BEEEEEEDDDEEEEEEEDWWEEEEEEEEDFFFFDEEEEBWWWWWEEEFFFFFFEEEEEEEEEEEEEEEEEBWWWWWWWWEEEEEEEEEFFFFFDDWWWWB
BEEEEEEDDDEEEEEEEDDDDDEEEEEEDFFFFDEEEEBEEEEEEEEFFFFFFEEEEEEEEEEEEEEEEEBWWWWWWWWEEEEEEEEEEEEEEDDWWWWB
BEEEEEEEEEEEEEEEEEEEEEEEEEEEDDDEDDEEEEBEEEEEEEEEEEEEEEEEEEEEEEEEEEEEEEBEEEEEEEEEEEEEEEEEEEEEEDDEEEEB
BEEEEEEEEEEEEEEEEEEEEEEEEEEEEEEEEEEEEEBEEEEEEEEEEEEEEEEEEEEEEEEEEEEEEEBEEEEEEEEEEEEEEEEEEEEEEDDEEEEB
BEEEEEEEEEEEEEEEEEEEEEEEEEEEEEEEEEEEEEBBBBBBBBBDDDBBBBBBBBBBBBBBBEBBBBBBBBBBBBBDDBBBBBEBBBBBBDDEEEEB
BEEEEEEEEEEEEEEEEEEEEEEEEEEEEEEEEEEEEEEEEEEEEEEEEEEEEEEEEEEEEEEEEEEEEEEEEEEEEEEEEEEEEEEEEEEEEDDEEEEB
BDDDDDEEEEEEEEEEEEEEEEEEEEEEEEEEEEEEEEEEEEEEEEEEEEEEEEEEEEEEEEEEEEEEEEEEEEEEEEEEEEEEEEEEEEEEEEEEEEEB
BFFDEEEEEEEEEEEEEEEFFFFFFFFEEEEEEEEEEEEEEEEEEEEEEEEEEEEEEEEEEEEEEEEEEEEEEEEEEEEEEEEEEEEEEEEEEEEEEEEB
BFFDEEEEEEEEEEEEEEEEEEFFFFFEEEEEEEEEEEEEEEEEEEEEEEEEEEEEEEEEEEEEEEEEEEEEEEEEEEEEEEEEEEEEEEEEEDDEEEEB
BEEDEEEEEEEEEEEEEEEEEEEEEEEEEEEEEEEEEEEEEEEEEEEEEEEEEEEEDDDDDDEEEEEEEEEEEDDDDDDDEEEEEEEEEEEEEDDEEEEB
BEEEEEEEEEEEEEEEEEEEEEEEEEEEEEEEEEEEEEEEEEEEEEEEEEEEEEEEDFEEEDEEEEEEEEEEEDEEEEWDEEEEEEEEEEEEEDDEEEEB
BEEDDDEEEEEEEEEEEEEEEEEEEEEEEEEEEEEEEEEEEEDDEEEEEEEEEEEEDFEEEEEEEEEEEEEEEEEEEEWDEEEEEEEEEEEEEDDEEEEB
BWWDEEEEEEEEEEEEEEEEEEEEEEEEEWWWEEEEEEEEEEDDEEEEEEEEEEEEDFEEEDEEEEEEEEEEEDEEEEWDEEEEEEEEEEEEEDDEEEEB
BWWDEEEEEEEEEEEEEEEEEEEEEEEEEWWWWWWEEEEEEEDDEEEEEEEEEEEEDDDDDDEEEEEEEEEEEDDDDDDDEEEEEEEEEEEEEDDEEEEB
BDDDEEEEEEEEEEEDDDDDEEEEEEEEEWWWWWWEEEEEEEDDEEEEEEEEEEEEEEEEEEEEEEEEEEEEEEEEEEEEEEEEEEEEEEEEEDDEEEEB
BEEEEEEEEEEEEEEDWWWEEEEEEEEEEEEEEEEEEEEEEEDDEEEEEEEEEEEEEEEEEEEEEEEEEEEEEEEEEEEEEEEEEEEEEEEEEDDEEEEB
BEEEEEEEEEEEEEEDWWWEEEEEEEEEEEEEEEEEEEEEEEEEEEEEEEEEEEEEEEEEEEEEEEEEEEEEEEEEEEEEEEEEEEEEEEEEEDDEEEEB
BEEEEEEEEEEEEEEDWWWEEEEEEEEEEEEEEEEEEEEEEEEEEEEEEEEEEEEEEEEEEEEEEEEEEEEEEEEEEEEEEEEEEEEEEEEEEDDEEEEB
BEEEEEEEEEEEEEEDDDDDEEEEEEEEEEEEEEEEEEEEEEEEEBBBBBBBBDBBBBBEBBBBBEEEEEBBBBBBBDDBBBBEBBBBBBBBBDDEEEEB
BDDDEEEEEEEEEEEEEEEEEEEEEEEEEEEEEEEEEEEEEEEEEBWEEEEEEEEEEEEEEEEEBEEEEEBEEEEEEEEEEEEEEEEEEEEEEDDFFFFB
BWWWDEEEEEEEEEEEEEEEEEEEEEEEEEEEEEEEEEEEEEEEEBWEEEEEEEEEEEEEEEEEBEEEEEBEWWWWEEEEEEEEEEEFFFFFFDDFFFFB
BWWWDEEEEEEEEEEEEEEEEEEEEEEEEEEEEEEEEEEEEEEEEBWWWWEEEEEEEFFFFFFFBEEEEEBEWWWWEEEEEEEEEEEFFFFFFDDFFFFB
BBBBBBBBBBBBBBBBBBBBBBBBBBBBBBBBBBBBBBBBBDDDBBBBBBBBBBBBBBBBBBBBBEBBBBBBBBBBBBBBBBBBBBBBBBBBBBBBBBBB
BFFFDFEEEEEEEEEWDEEEEEEEWWDEEEEEEEEEEEEEEEEEEEEEEEEEEEEEEEEEEEEEEEEEEEEEDFFEEEEEEEEEEEEEEEEEDWWWWWWB
BFFFDFEEEEEEEEEWDEEEEEEEWWDEEEEEEEEEEEEEEEEEEEEEEEEEEEEEEEEEEEEEEEEEEEEEDFFEEEEEEEEEEEEEEEEEDWWWWWWB
BEEEDFEEEEEEEEEWDEEEEFFFWWDEEEEEEEEEEEEEEEEEEEEEEEEEEEEEEEEEEEEEEEEEEEEEDFFEEEEEEEEEEEEEEEEEDFEEEEEB
BEEEDDDDDDDDEEDDDEEEDDDDDDDEEEEEEEEEEEEEEEEEEEEEEEEEEEEEEEEEEEEEEEEEEEEEDDDDDDDDEEEEEEEEEEEEDFEEEEEB
BEEEDEEEEEEEEEEEEEEEEEEEEEEEEEEEEEEEEEEEEEEEEEEEEEEEEEEEEEEEEEEEEEEEEEEEEEEEEEEEEEEEEEEEEEEEDFEEEEEB
BEEEDEEEEEEEEEEEEEEEEEEEEEEEEEEEEEEEEEEEEEEEEEEEEDDEEEEDDDDDDDEEEEEEEEEEEEEEEEEEEEEEEEEEEEEEDFEEEEEB
BEEEDEEEEEEEEEEEEEEEEEEEEEEEEEEEEEDDDDDDEEEEEEEEEDDEEEEDFEEEEDEEEEEEEEEEEEEEEEEEEEEEEEEEEEEEDDDDEEEB
BEEEEEEEEEEEEEEEEEEEEEEEEEFFEEEEEEDWWEEDEEEEEEEEEDDEEEEDDDEEDDEEEEEEEEEEEEEEEEEEEEEEEEEEEEEEEEEEEEEB
BEEEEEEEEEEEEEEEEEEEEEEEEEFFEEEEEEDWWEEEEEEEEEEEEDDEEEEEEEEEEEEEEEEEEEEEEEEEEEEEEEEEEEEEEEEEEEEEEEEB
BEEEDEEEEEEEEEEEEEEEEEEEEEFFEEEEEEDDDDDDEEEEEEEEEDDEEEEEEEEEEEEEEEEEEEEEEEEEEEEEEEEEEEEEEEEEDDDDDDDB
BEEEDEEEEEEEEEEEEEEEEEEEEEEEEEEEEEEEEEEEEEEEEEEEEDDEEEEEEEEEEEEEEEEEEEEEEEEEEEEEEEEEEEEEEEEEDWWWFFFB
BEEEDEEEEEEEEEEDDDDDDEEEEEEEEEEEEEEEEEEEEEEEEEEEEEEEEEEEEEEEEEEEEEEEEDDDDDDDDDDEEDDDEEEEEEEEDWWWFFFB
BWWWDEEEEEEEEEEEEEWWDEEEEEEEEEEEEEEEEEEEEEEEEEEEEEEEEEEEEEEEEEEEEEEEEDWWEEEEEEEEEEEDEEEEEEEEDEEEEEEB
BWWWDEEEEEEEEEEEEEWWDEEEEEEEEEEEEEEEEEEEEEEEEEEEEEEEEEEEEEEEEEEEEEEEEDWWEEEEEEEEEEEDEEEEEEEEEEEEEEEB
BBBBBBBBBBBBBBBBBBBBBBBBBDDDBBBBBBBBBBBBBBBBEEEBBBBBBBBBBBBBDDDDBBBBBBBBBBBBBBBBBBBBBBDDDDBBBBBBBBBB
BFFFFDEEEEEEEEWWDEEEEEEEEEEEEEDWWEEEEEFFFDEEEEEEEEEEEEEEEEEEEEEEEEEEEEEDWWEEEEEEDEEEEEEEEEEEDWWWWWWB
BFFFFDEEEEEEEEWWDEEEEEEEEEEEEEDWWEEEEEFFFDEEEEEEEEEEEEEEEEEEEEEEEEEEEEEDWWEEEEEEDEEEEEEEEEEEDWWWWWWB
BEEEEDEEEDDDDDDDDEEEEEEEEEEEEEDDDDDDEDDDDDEEEEEEEEEEEEEEEEEEEEEEEEEEEEEDWWEEEEEEDEEEEEEEEEEEDEEEEEEB
BEEEEDEEEEEEEEEEEEEEEEEEEEEEEEEEEEEEEEEEEEEEEEEEEEEEEEEEEEEEEEEEEEEEEEEDDDDDDDDEDEEEEEEEEEEEDEEEEEEB
BEEEEDEEEEEEEEEEEEEEEEEEEEEEEEEEEEEEEEEEEEEEEEEEEEEEEEEEEEEEEEEEEEEEEEEEEEEEEEEEEEEEEEEEEEEEDEEEEEEB
BEEEDDEEEEEEEEEEEEEEEEEEEEEEEEEEEEEEEEEEEEEEEEEEEEEEEEEEEEEEEEEEEEEEEEEEEEEEEEEEEEEEEEEEEEEEDEEEEEEB
BEDDDEEEEEEEEEEEEEEEEEEEEEEEEEEEEEEEEEEEEEEEEEEEEEEEDDDDDDDEEEEEEEEEEEEEEEEEEEEEEEEEEEEEEEEEDEEEEEEB
BEEEEEEEEEEEEEEEEEEEEWWWWWWWEEEEEEEEEEEEEEEEEEEEEEEEDDDDDDDEEEEEEEEEEEEEEEEEEEEEEEEEEEEEEEEEDEEEEEEB
BEEEEEEEEEEEEEEEEEEEEWWWWWWWEEEEEEEEEEEEEEEEEEEEEEEEEEEEEEEEEEEEEEEEEEEEEWWEEEEEEEEEEEEEEEEEDDDDEEEB
BDDDDDDDDEEEEEEEEEEEEWWWWWWWEEEEEEEEEEEEEEEEEEEEEEEEEEEEEEEEEEEEEFFFEEEEEWWEEEEEEEEEEEEEEEEEEEEEEEEB
BFFEEEEEDEEEEEEEEEEEEEEEEEEEEEEEEEEEEEEEEEEEEEEEEEEEEEEEEEEEEEEEEFFFEEEEEEEEEEEEEEEEEEEEEEEEDDDDEEEB
BFFEEEEEEEEEEEEEEEEEEEEEEEEEEEEEEEEEEEEEEEEEEEEEEEEEEEEEEEEEEEEEEFFFEEEEEEEEEEEEEEEEEEEEEEEEDEEEEEEB
BFFEEEEEDEEEEEEEEEEEEEEEEEEEEEEEEEEEEEEEEEEEEEEEEEEEEEEEEEEEEEEEEEEEEEEEEEEEEEEEEEEEEEEEEEEEDEEEEEEB
BDDDDDDDDEEEEEEEEEEEEEEEEEEEEEEEEEEEEEEEEEEEEEEEEEEEEEEDEDDDEEEEEEEEEEEEEEEEEEEEEEEEEEEEEEEEDEEEEEEB
BEEEEEEEEEEEEEEEEEEEEEEEEEEEEEEEEEEEEEEEEEEEEEEEEEEEEEEDEEEDEEEEEEEEEEEEEEEEEDDDDDDDEDDDDEEEDEEEEEEB
BEEEEEEEEEEEEEEDDDDEEDDDDDDDEEEEEEEEEDDDEDDDDEEEEEEEEEEDEEEDDEEEEEEEEEEEEEEEEDWEEEEEEEEFDEEEDEEEEEEB
BDDDDDDDDEEEEEEDWWEEEEEEEFFDEEEEEEEEEDFEEEEWDEEEEEEEEEEDEEEFDEEEEEEEEEEEEEEEEDWEEEEEEEEFDEEEDFFFFFFB
BWWWEEEEEEEEEEEDWWEEEEEFFFFDEEEEEEEEEDFEEEEWDEEEEEEEEEEDFFFFDEEEEEEEEEEEEEEEEDWWWWEEFFFFDEEEDFFFFFFB
BBBBBBBBBBBBBBBBBBBBBBBBBBBBBBBDDDBBBBBBBBBBBBBBDDDBBBBBBBBBBBBBBEEBBBBBBBBBBBBBBBBBBBBBBBBBBBBBBBBB
BFFEEEEEEEEEEEEEEEEEEEWBEEWWWWDEEEEEEDFFFEWWWDEEEEEEEEEEEEEFFDEEEEEEEEBFWWWWWWDFFEEEWWWDEEEEEEEEWWWB
BFFEEEEEEEEEEEEDEEEEEEWBEEEEEWDEEEEEEDFEEEEEWDEEEEEEEEEEEEEFFDEEEEEEEEBFFEEEEWDFFEEEEWWDEEEEEEEEWWWB
BFFEEEEDEDEEEEEDEEEEEEWBEEEEEWDEEEEEEDFEEEEEWDEEEEEEEDDDDDDDDDEEEEEEEEBFFEEEEWDEEEEEEEEDEEEEEEEEWWWB
BFFEEEEDEDFFFFFDWWWWWWWBEEEEEWDEEEEEEDFEEEEEWDEEEEEEEEEEEEEEEEEEEEEEEEBEEEEEEEDDDDEDDDDDEEEEEEEEFFFB
BDDDDDDDEDDDDDDDDDDDDDDBEDDDDDDEEEEEEDDDDEDDDDEEEEEEEEEEEEEEEEEEEEEEEEBEEEEEEEDEEEEEEEEDEEEEEEEEFFFB
BEEEEEEEEEEEEEEEEEEEEEEBEEEEEEEEEEEEEEEEEEEEEEEEEEEEEEEEEEEEEEEEEEEEEEBEEEEEEEEEEEEEEEEEEEEEEEEEFFFB
BEEEEEEEEEEEEEEEEEEEEEEBEEEEEEEEEEEEEEEEEEEEEEEEEEEEEEEEEEEEEEEEEEEEEEBDDDDDDDDEEEEEEEEDDDDDDDDDDDDB
BEEEEEEEEEEEEEEEEEEEEEEBEEEEEEEEEEEEEEEEEEEEEEEEEEEEEEEEEEEEEEEEEEEEEEBEEEEEEEEEEEEEEEEEEEEEEEEEEEEB
BEEEEEEEEEEEEEEDDDDDDDDBEEEEEEEEEEEEEEEEEEEEEEEEEEEEEEEEEEEEEEEEEEEEEEBEEEEEEEEEEEEEEEEEEEEEEEEEEEEB
BEEEEEEEEEEEEEEEEEEEEWWBEEEEEEEEEEEEDDDDDDEEEEEEEEEEEEEEEEEEEEEEEEEEEEBEEEEEEEEEEEEEEEEEEEEEEEEEEEEB
BEEEEEEEEEEEEEEEEEEEEWWBEEEEEEEEEEEEDFEEEDEEEEEEEEEEEEEEEEEEDDDDDEEEEEBEEEEEEEEEEEEEEEEEEEEEEEEEEEEB
BEEEEEEEEEEEEEEEEEEEEEEBEEEEEEEEEEEEDFEEEEEEEEEEEEEEEEEEEEEEEEEWDEEEEEDEEEEEEEEEEEEEEEEEEEEEEEEEEEEB
BBBBBBBEEBBBBBBBBBBBBDDBEEEEEEEEEEEEDFEEEDEEEEEEEEEEEEEEEEEEDDDDDEEEEEBEEEEEEEEEEEEEEEEEEEEEEEEEEEEB
BEEEEEEEEEEEEEEEEEEEEEEEEEEEEEEEEEEEDDDDDDEEEEEEEEEEEEEEEEEEEEEEEEEEEEBEEEEEEEEEEEEEEEEEEEEEEEEEEEEB
BEEEEEEEEEEEEEEEEEEEEEEEEEEEEEEEEEEEEEEEEEEEEEEEEEEEEEEEEEEEEEEEEEEEEEBEEEEEEEEEEEEEEEEEEEEEEEEEEEEB
BEEEEEEEEEEEEEEEEEEEEEEEEEEEEEEEEEEEEEEEEEEEEEEEEEEEEEEEEEEEEEEEEEEEEEBEEEEEEEEEEEEEEEEEEEEDDDDDDDEB
BEEEEEEEEEEEEEEEEEEEEEEEEEEEEEEEEEEEEEEEEEEEEEEEEEEEEEEEEEEEEEEEEEEEEEEEEEEEEEEEEEEEEEEEEEEDWWEEEEEB
BDDDDDDDDEEEEEEEEEEEEEEEEEEEEEEEEEEEEEEEEEEEEEEEEEEEEEEEEEEEEEEEEEEEEEBDDDDDEEEEEDDEDDDDEEEDWWEEEEEB
BWFFFEEEDEEEEEEEEEEEEDDDDDDDDEDDDEEEEEEEEDDDEDDDDDEEEEEEEEEEDDDDDDDDDDBEEEEEEEEEEDEEEEWDEEEDWWEEEEEB
BWEEEEEEDEEEEEEEEEEEEDWEEEEEEEEFDEEEEEEEEDFEEEEFFDEEEEEEEEEEDEEEEEEEWWBFFEEDEEEEEDEEEEWDEEEDWFFFFEEB
BWEEEEEEEEEEEEEEEEEEEDWEEEEEEFFFDEEEEEEEEDFEEEEFFDEEEEEEEEEEEEEEEEEEWWBFFEEDEEEEEDEEEEWDEEEDWFFFFEEB
BBBBBBBBBBBBBBBBBBBBBBBBBBBBBBBBBBBBBBDDBBBBBBBBBBEEBBBBBBBBBBBBBBBBBBBBBBBBBBBDBBBBBBBBEEBBBBBBBBBB
BEEEEWWDEEEEEEEEEEEEEEEEEEEBFEEEDEEEEEEEEEDWWWWDEEEEEDWEEEEEEBEEEEEWWDEEEEEEEEEEEEEEFDEEEEEEDWWEEEEB
BEEEEWWDEEEEEEEEEEDEEEEEEEEBFEEEDEEEEEEEEEDEEEEDEEEEEDWEEEEEEBEEEEEWWDEEEEEEEEEEEEEEFDEEEEEEDWWEEEEB
BEEEEEEDEEEEEEEEEEDWWWEEEFFBFEEEEEEEEEEEEEDEEEEDEEEEEDWEEEEEEBEEEEEWWDEEEEEEEEEEEEEEFDEEEEEEDWWEEEEB
BEEEEFFDEEEEEEEEEEDWWWEEEFFBDDDDDEEEEEEEEEDEEEEDEEEEEDWEEEEEEBEDDDDDDDEEEEEEEEEEEDDDDDEEEEEEDWWEEEEB
BEEEEFFDEEEEEEEEEEDDDDDDDDDBEEEEEEEEEEEEEEDDDEDDEEEEEDDDDDDEEBEEEEEEEEEEEEEEEEEEEEEEEEEEEEEEDDDDDDEB
BEDDDDDDEEEEEEEEEEEEEEEEEEEEEEEEEEEEEEEEEEEEEEEEEEEEEEEEEEEEEBEEEEEEEEEEEEEEEEEEEEEEEEEEEEEEEEEEEEEB
BEEEEEEEEEEEEEEEEEEEEEEEEEEEEEEEEEEEEEEEEEEEEEEEEEEEEEEEEEEEEBEEEEEEEEEEEEEEEEEEEEEEEEEEEEEEEEEEEEEB
BEEEEEEEEEEEEEEEEEEEEEEEEEEBDDDDDDEEEEEEEEEEEEEEEEEEEEEEEEEEEBDDDDDDDDEEEEEEEEEEEEEEEEEEEEEEEEEEEEEB
BEEEEEEEEEEEEEEEEEEEEEEEEEEBWWWWWDEEEEEEEEEEEEEEEEEEEEEEEEEEEBWEEEEEEDEEEEEEEEEEEEEEEEEEEEEEEEEEEEEB
BEEEEEEEEEEEEEEEEEEDDDDDDDDBWEEEEDEEEEEEEEEEEEEEEEEEEEEEEEEEEBWEEEEEEDEEEEEEEEEEEEEEEEEEEEEEEDDDDDDB
BEEEEEEEEEEEEEEEEEEDEEEEEWWBWEEEEEEEEEEEEEEEEEEEEEEEEEEEEEEEEBDDDDDDEDEEEEEEEEEEEEEEEEEEEEEEEDWWWWWB
BDDDDDDDDDDEEEEEEEEDEEEEEWWBFEEEEDEEEEEEEEEEEEEEEEEEEEEEEEEEEDEEEEEEEEEEEEEEEEEEEEEEEEEEEEEEEDDWWWWB
BWWEEEEEFFDEEEEEEEEEEEEEEFFBFFEEEDEEEEEEEEEEEEEEEEEEEEEEEEEEEBEEEEEEEEEEEEEEEEEEEEEEEEEEEEEEEEDEEEEB
BWWEEEEEFFDEEEEEEEEDEEEEEFFBDDDDDDDDDEEEEEEEEEEEEEEEEDDDDDDDDBEEEEEEEEEEEEEEEEEEEDDDEDDDEEEEEEDEEEEB
BEEEEEEEEEDEEEEEEEEDDDDDDDDBWWWEEEEEDEEEEEEEEEEEEEEEEDWWWWFFFBEEEEEEEEEEEEEEEEEEEDEEEEEDEEEEEEDEEEEB
BEEEEEEEEEDEEEEEEEEEEEEEEEEDEEEEEEEEDEEEEEEEEEEEEEEEEDEEEEEEFBDDDDDDDDEEEEEEEEEEEDEEEEEDEEEEEEDEEEEB
BEEEEEEEEEDEEEEEEEEEEEEEEEEDEEEEEEEEEEEEEEEEEEEEEEEEEDEEEEEEFBFFEEEEEEEEEEEEEEEEEDFFEWWDEEEEEEDEEEEB
BEEEEEEEEEEEEEEEEEEEEEEEEEEDEEEEEEEEEEEEEEEEEEEEEEEEEEEEEEEEFBFFEEEEEEEEEEEEEEEEEDFFEWWDEEEEEEEEEEEB
BBBBBBBBBBBBBBBBBBBBBBBBBBBBBBBBBBBBBBBBBBBBBBBBBBBBBBBBBBBBBBBBBBBBBBBBBBBBBBBBBBBBBBBBBBBBBBBBBBBB